//MAP CONVERTED BY dmm2tgm.py THIS HEADER COMMENT PREVENTS RECONVERSION, DO NOT REMOVE
"a" = (
/turf/open/space/basic,
/area/space)
"e" = (
/turf/closed/wall/mineral/titanium/nodiagonal,
/area/space)
"g" = (
/obj/structure/grille,
/turf/open/floor/plating,
/area/space)
"i" = (
/turf/open/floor/suns/plain,
/area/space)
"x" = (
/obj/structure/grille,
/turf/open/space/basic,
/area/space)
"C" = (
/obj/structure/window/reinforced/fulltile,
/turf/open/space/basic,
/area/space)
"D" = (
/turf/closed/wall/mineral/titanium/exterior,
/area/space)
"I" = (
/turf/open/floor/plating,
/area/space)
"J" = (
/turf/open/floor/suns/dark/plain,
/area/space)

(1,1,1) = {"
i
J
D
e
C
x
I
a
a
a
a
a
a
a
a
a
a
a
a
a
"}
(2,1,1) = {"
a
a
a
a
a
a
a
a
a
a
a
a
a
a
a
a
a
a
a
a
"}
(3,1,1) = {"
a
a
a
a
a
a
a
a
a
a
a
a
a
a
a
a
a
a
a
a
"}
(4,1,1) = {"
a
a
a
a
a
a
a
a
a
a
a
a
a
a
a
a
a
a
a
a
"}
(5,1,1) = {"
a
a
a
a
a
a
a
a
a
a
a
a
a
a
a
a
a
a
a
a
"}
(6,1,1) = {"
a
a
a
a
a
a
a
a
a
a
a
a
a
a
a
a
a
a
a
a
"}
(7,1,1) = {"
a
a
a
a
a
a
a
a
a
a
a
a
a
a
a
a
a
a
a
a
"}
(8,1,1) = {"
a
a
a
a
a
a
a
a
a
a
a
a
a
a
a
a
a
a
a
a
"}
(9,1,1) = {"
a
a
a
a
a
a
a
a
a
a
a
a
a
a
a
a
a
a
a
a
"}
(10,1,1) = {"
a
a
a
a
a
a
a
a
a
a
a
a
a
a
a
a
a
a
a
a
"}
(11,1,1) = {"
a
a
a
a
a
a
a
a
a
a
a
a
a
a
a
a
a
a
a
a
"}
(12,1,1) = {"
a
a
a
a
I
I
I
I
I
I
I
I
I
I
I
a
a
a
a
a
"}
(13,1,1) = {"
a
a
a
a
I
I
I
I
I
I
I
I
I
I
I
a
a
a
a
a
"}
(14,1,1) = {"
a
a
a
a
I
I
I
I
I
I
I
I
I
I
I
a
a
a
a
a
"}
(15,1,1) = {"
a
a
a
a
I
I
I
I
I
I
I
I
I
I
I
a
a
a
a
a
"}
(16,1,1) = {"
a
a
a
a
I
I
I
I
I
I
I
I
I
I
I
a
a
a
a
a
"}
(17,1,1) = {"
a
a
a
a
I
I
I
I
I
I
I
I
I
I
I
a
a
a
a
a
"}
(18,1,1) = {"
a
a
a
a
I
I
I
I
I
I
I
I
I
I
I
a
a
a
a
a
"}
(19,1,1) = {"
a
a
a
D
D
D
D
D
I
I
I
D
D
D
D
D
a
a
a
a
"}
(20,1,1) = {"
a
a
a
D
I
I
I
D
I
I
I
D
I
I
I
D
a
a
a
a
"}
(21,1,1) = {"
a
a
a
D
I
I
I
D
I
I
I
D
I
I
I
D
a
a
a
a
"}
(22,1,1) = {"
a
a
a
D
I
I
I
D
I
I
I
D
I
I
I
D
a
a
a
a
"}
(23,1,1) = {"
a
a
a
D
I
I
I
D
I
I
I
D
I
I
I
D
a
a
a
a
"}
(24,1,1) = {"
a
a
a
D
I
I
I
D
I
I
I
D
I
I
I
D
a
a
a
a
"}
(25,1,1) = {"
a
a
a
D
g
I
I
D
I
I
I
D
I
I
g
D
a
a
a
a
"}
(26,1,1) = {"
a
a
a
a
g
g
g
D
I
I
I
D
g
g
g
a
a
a
a
a
"}
(27,1,1) = {"
a
a
a
a
a
a
a
D
I
I
I
D
a
a
a
a
a
a
a
a
"}
(28,1,1) = {"
a
a
a
a
a
a
a
a
a
a
a
a
a
a
a
a
a
a
a
a
"}
(29,1,1) = {"
a
a
a
a
a
a
a
a
a
a
a
a
a
a
a
a
a
a
a
a
"}
(30,1,1) = {"
a
a
a
a
a
a
a
a
a
a
a
a
a
a
a
a
a
a
a
a
"}
