//MAP CONVERTED BY dmm2tgm.py THIS HEADER COMMENT PREVENTS RECONVERSION, DO NOT REMOVE
"a" = (
/turf/open/space/basic,
/area/space)
"e" = (
/turf/closed/wall/mineral/titanium/nodiagonal,
/area/space)
"g" = (
/obj/structure/grille,
/turf/open/floor/plating,
/area/space)
"i" = (
/turf/open/floor/suns/plain,
/area/space)
"l" = (
/obj/structure/chair/comfy/shuttle{
	dir = 4
	},
/turf/open/floor/suns/dark/pattern,
/area/space)
"q" = (
/obj/structure/table/wood/reinforced,
/turf/open/floor/suns/dark,
/area/space)
"s" = (
/obj/machinery/computer/helm{
	dir = 8
	},
/turf/open/floor/suns/dark,
/area/space)
"u" = (
/turf/open/floor/suns/dark,
/area/space)
"v" = (
/turf/open/floor/suns/dark/pattern,
/area/space)
"x" = (
/obj/structure/grille,
/turf/open/space/basic,
/area/space)
"y" = (
/obj/machinery/modular_computer/console/preset/command,
/turf/open/floor/suns/dark,
/area/space)
"C" = (
/obj/structure/window/reinforced/fulltile,
/turf/open/space/basic,
/area/space)
"D" = (
/turf/closed/wall/mineral/titanium/exterior,
/area/space)
"G" = (
/obj/machinery/computer/cargo{
	dir = 8
	},
/turf/open/floor/suns/dark,
/area/space)
"I" = (
/turf/open/floor/plating,
/area/space)
"J" = (
/turf/open/floor/suns/dark/plain,
/area/space)
"M" = (
/turf/open/floor/suns/grid,
/area/space)
"Z" = (
/turf/open/floor/suns/hatch{
	color = "#56342A"
	},
/area/space)

(1,1,1) = {"
i
J
D
e
C
x
I
a
a
a
a
a
a
a
a
a
a
a
a
a
"}
(2,1,1) = {"
a
a
a
a
a
a
a
a
a
a
a
a
a
a
a
a
a
a
a
a
"}
(3,1,1) = {"
a
a
a
a
a
a
a
a
a
a
a
a
a
a
a
a
a
a
a
a
"}
(4,1,1) = {"
a
a
a
a
a
a
a
a
a
a
a
a
a
a
a
a
a
a
a
a
"}
(5,1,1) = {"
a
a
a
a
a
a
a
a
a
a
a
a
a
a
a
a
a
a
a
a
"}
(6,1,1) = {"
a
a
a
a
a
a
a
a
a
a
a
a
a
a
a
a
a
a
a
a
"}
(7,1,1) = {"
a
a
a
a
a
a
a
a
a
a
a
a
a
a
a
a
a
a
a
a
"}
(8,1,1) = {"
a
a
a
a
a
a
a
a
a
a
a
a
a
a
a
a
a
a
a
a
"}
(9,1,1) = {"
a
a
a
a
a
a
a
a
a
a
a
a
a
a
a
a
a
a
a
a
"}
(10,1,1) = {"
a
a
a
a
a
a
a
a
a
a
a
a
a
a
a
a
a
a
a
a
"}
(11,1,1) = {"
a
a
D
D
D
D
D
D
D
I
D
D
D
D
D
D
D
a
a
a
"}
(12,1,1) = {"
a
a
D
I
I
D
I
I
i
i
D
I
I
D
I
I
D
a
a
a
"}
(13,1,1) = {"
a
a
D
I
I
D
I
I
i
i
D
I
I
D
I
I
D
a
a
a
"}
(14,1,1) = {"
a
a
D
D
D
D
I
I
i
i
D
D
D
D
I
I
D
a
a
a
"}
(15,1,1) = {"
a
a
D
I
I
I
I
I
i
i
D
I
I
I
I
I
D
a
a
a
"}
(16,1,1) = {"
a
a
D
I
I
I
I
I
i
i
D
I
I
I
I
I
D
a
a
a
"}
(17,1,1) = {"
a
a
D
I
I
I
I
I
i
i
D
I
I
I
I
I
D
a
a
a
"}
(18,1,1) = {"
a
a
D
D
I
I
I
I
i
i
D
I
I
I
I
D
D
a
a
a
"}
(19,1,1) = {"
a
a
a
D
D
D
D
D
D
i
D
D
D
Z
D
D
a
a
a
a
"}
(20,1,1) = {"
a
a
a
D
u
u
u
D
i
i
J
D
Z
Z
Z
D
a
a
a
a
"}
(21,1,1) = {"
a
a
a
D
u
i
i
i
i
i
J
D
Z
Z
Z
D
a
a
a
a
"}
(22,1,1) = {"
a
a
a
D
u
i
i
D
i
i
J
D
Z
Z
Z
D
a
a
a
a
"}
(23,1,1) = {"
a
a
a
D
q
v
v
D
i
i
J
D
Z
Z
Z
D
a
a
a
a
"}
(24,1,1) = {"
a
a
a
D
y
l
v
D
i
i
J
D
Z
Z
Z
D
a
a
a
a
"}
(25,1,1) = {"
a
a
a
D
g
s
G
D
i
i
J
D
Z
Z
g
D
a
a
a
a
"}
(26,1,1) = {"
a
a
a
a
g
g
g
D
i
i
i
D
g
g
g
a
a
a
a
a
"}
(27,1,1) = {"
a
a
a
a
a
a
a
D
M
M
M
D
a
a
a
a
a
a
a
a
"}
(28,1,1) = {"
a
a
a
a
a
a
a
a
a
a
a
a
a
a
a
a
a
a
a
a
"}
(29,1,1) = {"
a
a
a
a
a
a
a
a
a
a
a
a
a
a
a
a
a
a
a
a
"}
(30,1,1) = {"
a
a
a
a
a
a
a
a
a
a
a
a
a
a
a
a
a
a
a
a
"}
